111111111111111
101000000000001
101011111111101
101010000000101
101010111110101
101010100010101
101010101010101
101010101010101
101010101010101
101010111010101
101010000010101
101011111110101
101000000000101
101111111111101
100000000000001
111111111111111