111111
1P1111
100101
1C0101
1CC0E1
111111