1111111111
1E1CC0C0C1
1C1C111101
101C11P1C1
1C1C1101C1
101C1101C1
1010CCC101
1011111101
10C0C0C0C1
1111111111